9
16
################
#-------------A#
#---###------###
#----A--------2#
#--------------#
#-1------------#
#---------##---#
#---------##---#
################
1,1*
3,2-1
2,8-2