10
16
################
#-------------H#
#---###-#---##-#
#---#-G-#----3-#
#---#####------#
#-2------------#
#----G----##---#
#---------##-4-#
#--------------#
################
1,1*
3,2-2
2,10-3
4,10-4