9
16
################
#-------------B#
#---###------###
#----A--------1#
#--------------#
#-1------------#
#---------##---#
#---------##---#
################
1,1*
3,2-A
2,8-B