

################
#0000000000000@#
#000###000000###
#0000@000000001#
#00000000000000#
#0010000@000000#
#000000000##000#
#000000000##000#
################
