9
8
########
###---##
#1----##
###--1##
#1##--##
#-#-1-##
#--1--1#
#---1--#
########
2,2*
2,3-1
3,4-1
4,4-1
6,1-1
6,3-1
6,4-1
6,5-1