9
16
################
#-------------H#
#---###------###
#----H--------3#
#--------------#
#-2------------#
#---------##---#
#---------##---#
################
1,1*
3,2-2
2,8-3