################
#0000P000B0000@#
#000###000000###
#0000@000000000#
#000000000B0000#
#0000000@000000#
#00B000000##000#
#000000000##000#
################