     ###
######P#####
#@00000000@#
#B00000000B#
#0000000000#
############