9x8

0 0 1 1 1 1 1 0
1 1 1 2 2 2 1 0
1 3 2 2 2 2 1 0
1 1 1 2 2 3 1 0
1 3 1 1 2 2 1 0
1 2 1 2 3 2 1 1
1 2 2 3 2 2 3 1
1 2 2 2 3 2 2 1
1 1 1 1 1 1 1 1

(2,2)
4(2,3)(2,1)-0(3,4)-0(4,4)-0(6,1)-0(6,3)-0(6,4)-0(6,5)
