######
#00@0#
#0BP0#
#0000#
######